R 1400 900
NO  ./txt/mur.xpm
SO    ./txt/mur_pierre.xpm
WE  ./txt/mur2.xpm
EA   ./txt/mur_brique.xpm
S  ./txt/arbre.xpm
SB ./txt/3.xpm
F    85,64,46
C   41,44,52

11111111111111111
10000000000000101
10100000001100001
10001000002100001
10010004001010001
10101002000000101
1110000N000100001
10001003000000101
10100000000100001
10001000000000101
10100000000100001
10001000000000101
11111111111111111